# Boseji's Bin Library

# Primary Header and Classes (KEYWORD1)
bosejis_Bin	KEYWORD1
bosejis_Bin.h	KEYWORD1
Bin	KEYWORD1

# Instances, Methods and Functions (KEYWORD2)
begin	KEYWORD2
capacity	KEYWORD2
length	KEYWORD2
write	KEYWORD2
Bytes	KEYWORD2
c_str	KEYWORD2
flush	KEYWORD2
sprintf	KEYWORD2
strfloat	KEYWORD2
strdouble	KEYWORD2
tostr	KEYWORD2
Hex	KEYWORD2
HexBuffer	KEYWORD2
HexArray	KEYWORD2
trimLeft	KEYWORD2
trimRight	KEYWORD2
isString	KEYWORD2
trim	KEYWORD2
read	KEYWORD2
unHex	KEYWORD2

# Structures, Pre-Processor and Other Functions (KEYWORD3)

# Constants (LITERAL1)

# Other Parts (LITERAL2)


